##########
#S     #E#
# ### ####
#   #    #
##########
